
SO ./so_good_so.xpm
NO ./no_good_no.xpm
EA ./ea_good_ea.xpm
WE ./we_good_we.xpm

F     1,23,222
C 225,12,222
                          
         1111111111111111111111111
         1000000000110000000000001
         1011000001110000000000001
         1001000000000000000000001
1111111110110000011100000000000011
1000000000110000011101111101111111
11110111111111011100000010001    
11110111111111011101010010001
11000000110101011100000010001
10000000000000001100000010001
10000000000000001101010010001
11000001110101011111011110N1111
111101111110101101011010011
111111111111111111111111111
111111111111111111111111111





                          